NO ./textures/bluestone.xpm
SO ./textures/eagle.xpm
WE ./textures/greystone.xpm
EA ./textures/redbrick.xpm

F 0,0,20
C 0,0,0

111111111111
100000000001
11100000111
1000000E01
111000001
100000000111
111111111111

