111111
111011
101001
1101N1
111111