NO ./textures/bluestone.xpm

SO ./textures/eagle.xpm
WE ./textures/greystone.xpm
EA ./textures/redbrick.xpm
F 59,59    ,59
C 100,100,100

        1111111111111111111111111
        1000000000110000000000001
        1011000001110000000000001
        1001000000000000000000001
111111111011000001110000000000001
100000000011000001110111111011111
11110111000011011100000010001
11110111011011011101010010001
11000000000001011100000010001
10000000000000001100000010001
10000000000000001101010000111
1100000111010101111100000N0011
11110111 1110101 100000000111
11111111 1111111 111111111111